11111111111
100000011E1
10000C00001
10000000001
100C0000001
10001111111
11100000001
10000000101
1P000001101
11111111111
