11111111111
10000001101
10000000001
10000000001
10000000001
10001111111
11100000001
10000000101
1N000001101
11111111111
