11111111111
10000000001
10000000001
10011101111
10000000011
11110000001
11100000001
110000N0001
10000000001
11111111111
