11111111111
10000000001
11110000001
10000010001
10000000001
1000N000001
10000000001
10000000001
10010000001
11111111111
