11111111111
1000W000001
11110000001
10000000001
10000000001
10000000001
10000000001
10000000001
10000000001
11111111111
